111111111
100C0C0C1
1111E1111
1000PCCC1
111111111