11111111111111111
1001110001110C0E1
1CC1110001110CCC1
1C011111111100CP1
10C0CCC0C111CCC01
1CCCCCCCC00000C01
11111111111111111