111111111
100CPC1B1
10B0E0111
10000C011
111111111