11111111111111111
1BCECBCBCBCCCCCB1
1CCCCBCBCBCCCCB01
1CCCCCCCCCCCCCCP1
11111111111111111