11111111111111111
10B1110001110B0E1
1CC111000B110CCC1
1C011111111100CP1
10C0CCC0B111CCC01
1CCCCCCCC00000C01
11111111111111111