111111111111111111
1C0000000E000000C1
110B01111B11110101
1B00000000000000B1
1B00000000000000B1
1B00000000000000B1
1B00000000000000B1
1B00000000000000B1
1B00000000000000B1
1B00000000000000B1
1B00000000000000B1
1B00000000000000B1
1B00000000000000B1
1B00000000000000B1
1B00000000000000B1
1B00000000000000B1
1B00000000000000B1
1B00000000000000B1
1B00000000000000B1
1B00000000000000B1
1B00000000000000B1
11C101011P11010C11
111111111111111111