111111111111111111111
10CCC0B0CC000CCCCC0B1
1BCCC000CC0000B0CC001
10CCCCCCCC0B0000CC0P1
10CCCCCCCC000CCCCCB01
100B0B0CCCB00CCE0B001
100B0B1CCC000CCCCCC01
111111111111111111111